0000000000000000000000000000000000000000000000000000000000000000000000000000000000000000000000000000000000000000000000000000000000000000000000000000000000000000000000000000000000000000000000000000000000000000000000000000000000000000000000000000000000000000000000000000000000000000000000000000000000000000000000000000000000000000000000000000000000000000000000000000000000000000000000000000000000000000000000000000000000000000
0000000000000000000000000000000000000000000000000000000000000000000000000000000000000000000000000000000000000000000000000000000000000000000000000000000000000000000000000000000000000000000000000000000000000000000000000000000000000000000000000000000000000000000000000000000000000000000000000000000000000000000000000000000000000000000000000000000000000000000000000000000000000000000000000000000000000000000000000000000000000000
0000000000000000000000000000000000000000000000000000000000000000000000000000000000000000000000000000000000000000000000000000000000000000000000000000000000000000000000000000000000000000000000000000000000000000000000000000000000000000000000000000000000000000000000000000000000000000000000000000000000000000000000000000000000000000000000000000000000000000000000000000000000000000000000000000000000000000000000000030000000000000
0000000000000000000000000000000000000000000000000000000000000000000000000000000000000000000000000000000000000000000000000000000000000000000000000000000000000000000000000000000000000000000000000000000000000000000000000000000000000000000000000000000000000000000000000000000000000000000000000000000000000000000000000000000000000000000000000000000000000000000000011111111111110000000000000000000000000000000000000000000000000000
0000000000000000000000000000000000000000000000000000000000000000000000000000000000000000000000000000000000000000000000000000000000000000000000001111000000000000000000011110000000000000000000000000000000000000000000000000000000000000000000000000000000000000000000000000000000000000000000000000000000000000000000000000000000000000000000000000000000000000000000011111111111110000000000000000000000000000000000000030000000000000
0000000000000000000000000000000000000000000000000000000000000000000000000000000000000000000000000000000000000000000000000000000000000000000000001000000000000000000000000000000000000000000000000000000000000000000000000000000000000000000000000000000000000000000000000000000000000000000000000000000000000000000000000000000000000000000000000000000000000000000000011111111111110000000000000000000000000000000000000000000000000000
0000000000000000000000000000000000000000000000000000000000000000000000000000000000000000000000000000000000000000000000000000000000000000000003000000000000000000000000000000000000000000000000000000000000000030000000000000000000000000000000000000000000000000000000000000000000000000000000000000000000000000000000000000000000000000000300000000000000000000000000011111111111110000000000000000000000000000000000000030000000000000
0000000000000000000000000000111111030300000000000000000000000000000000000000000000000000000000000000000000000000000003030000000000000000000000000000000000000000000000000000000003000300000000000000000000000000000000000000000000000000000000000000000000000000000000000000000000000011111111111100100000000000000000000000000000000000000000000000000000000000000000011111111111110000000000000000000000000000000000000000000000000000
0000000000000000000000000000000000000000000000000000000000000000000000003011110003000000000000000000000000000000000000000000000000000011111000000000000000000011100000000000000000000000000000000000000000030000003000000000000000000000000000000000000030000003000000000000000000000000000000000000100000000000000000000000000000000000000000000000000000000000011100011111111111110000000000000000000000000000000000000030000000000000
0000000000000000000301111000000000000000000000000000003000000000000000000000000000000000300000000000000000000000000000000000000000003000000000000000000000000000000000000000000000000000000000000000000000000000000000000000110303000000000000000000000000000000000000000000000000000000000000000000100000000000000000000000000003000000000000000000000000001111111100011111111111110000000000000300000000000000000000000000000000000000
0000000000000000000000000000000000000000000000003000000000000000000000001000000000000000000000000000000000000303000000000000001111100000000000000000000000000000000000000000000000000000000000000000000000000000300000000000100000000000000000000000000030000003000000300000000000000000000000011111111000000000000000000000000000030000000300000000011111111111111100000000000000000000003000000000000000000000000000000030000000000000
0000000000000000000000000000000000000000000000000000003000000000000000001000000000000000300000000000000000000000000111000000000000000000000000000000000000000000000000000000000000001111111000000000000000000000000000000000100000000000000000000000000000000000000000000000000000000000100011111111111000000000000003030300000000000000000000001111111111111111111100000000000000000000000000000000000000000000000000000000000000000000
1111111111111111111111111110000000000011111111111111111111111111111111111111111111111111111111111111111111111111111111111111111111111111111100000000000000000000000000000000000000000000000000000001111111111111000000111111111111111110001111111111111111111111111111110000111111111111111111111111111111111111111000000000111111111111111111111111111111111111111111111111111111111111111111110011111111111111111111111111111111111111